####################
#                  #
#      P           #
#           #####  #
#  X            #  #
#      X    X   #  #
#               #  #
#  #            ## #
# #########     #  #
#         #    ##  #
#      O  #     #  #
#         #    O   #
#      O  #        #
#         #        #
#                  #
#                  #
####################
