##############
#P#O         #
# #####  #  ##
# X          #
###   ###  # #
#  ##        #
#            #
#            #
#            #
#            #
##############
