###########
##       ##
##X##### ##
#  #   #O##
#    P #O##
##X## ##O##
##        #
##X####   #
#       ###
###########
